**.*.*......*..*..*..**....**.......**.....#.#*#..#*...*...*...*....*.*.*..#...#.*.#*.*.#*..****.#..
*.*.......#...*....*#.#....##.*#.*#**.....#*#.*...#*..........*....##.....*#.*..*#...*..*.#..*.##...
.......*.**..*...............*........*...**#.....#*.#..*.....#**....*#....***...*......*.#......*..
..*......**......*..............*.#...*....*#.*.....#.#...#...*.*..#....#..***#...........*..*..*...
.#.....**.*...*#.*..........*.*...*#*....*.*...*...*..*.#......*....*....*....*#...*...*.........*#.
*#...**..**##....*........#.......*#..*...............#..*.*#.......#.***.....**##*...*.*.**.*...*.*
......***....**..#..*#.*.*.*.......#*.#.#...*......**.....*....**.*..#........*...*.*...**.*.....*.#
.#.*..........#....*.....**.**....*#**.*.......#.*.*.....**.*#...**.*..**....*.....*......*..*...*..
....*..*......#..**..#....**#...#.#.*.......#.....#*.....*.*.*.*.*.*....**..*#.*.*....*.#*..........
.........##...*.#.**..#*....#.*.#....*.*#...#*.....**#....*.#.#.....*#........#..##.....*#...*...*..
......#.**.*...*.**...#...#.......##.....#.*#.*...*..*.#.....##*...*.*#*.*...*..*.**......*...*..*..
...*.#..*.#.......*.#.......*.*...#..*...#.**..*..*.**...*..*..#....#*....*.##...*..**#....#..#..*..
*....*...#*....#...*...*#.....##**...*...*.....*#.*..*.*.#..#....*..#..*.......#*.*..#.........****.
.**....#.*.*...*..........#...#....##..#*#....*#..**.*..#.#*.##..#...*.....*.#..........*....**.*...
#.#.....****.**.#*#.**...#...#...#..**...#.....*......*...*.*.....*.*....#*.........................
.*..*..#..*.*..***...#....*...*B.**.*#.*.*..........**......**#.*..**.....**###.*.*...#..**.*..*.#*.
..*......**...#.*.....*.*#..#...#...#.....*#.*.....*....*.*..*.*...*..*..**...................#.***.
*......*....**.*...#..*....**........#....**.#.***..***..*.....**....*****..**..*.*..#..........*.*.
*......**...*..**...#.*.#.*#*.*.#...*...*.........*...........*#.*..#**###....#.**..*.*.*#.*.....#..
.#..#..**..*.*#..*..#........**.***..**#.*.......#.**.*..*#*..*.*..*.#..*.***....#.....*..**.#.*..*.
..*..##..#.**.....#*..*.#.#.##..**....*.........#.#....#.*........*.*.....*.....#**....#.#.*.....*.*
...*..**..**#.*#...*.*......##..*.#.....**.......#..#*..*##*..#......##*....#*.****.....*....*......
.A#.*........#..***................*#.....*.*..*.....*.*...*.....#.......##.*.#....**#........**..*.
......#.*....##.#.......*...*...*..**.*....*.*##.**...#*..*.#.*...#....*.##*.*...*#*.........*.***.*
##...*##..#..#**.....**....*...**.*...*#.***.*....*.*......#...*....**.#....#.*...#.......*..**.*#..
....#.*.*...*...........*.....#..*...*.##.*...*.....*.*.**##..*..*......*#.*.#.....#..*#.....#..#**.
.*.*..*.**.#..**..*.*..*......*........*..*...#*.#.*...*..*....***.*..#...**....*........#...*......
.*..*...***..*....*.*...#.........*...*.*.......*#.....**....*....***.*.#..#*....#*...**.#.**..#....
..*#...#.#.**.**...#..*..#.......*......#..*..#*#..#......*.....*.*.#..*..#......*.........#.##*...#
...#......*.*#..*#......*...**.*.*.**.......*.#**#*#**..*.......*..........*..**.#...*..**.*......*.
##......*#.**..*.#....*...*...*...**##....*...*...##...**......##.*.#*#.#...*......*.*#.#.......#...
.**..*...*....*#***..*...*.....#.....##*.........*...**....#...*....*.*..*...#*...##*....#..#.*..*..
...*#........*....**#.*.**....*#.*.#*.....*.....#.#...**#..*.*#.....*...#..*#*................*.....
.*#...*........**.#..**....B.*.##.............*#...#...*.#...*##...#.#......*.*..*#.#....#....#..#..
..#...*#.**.*.....#.***..*.......#*..#......*...#..*.....*....*...#....*....#.*..*...*....*.#*....#.
...#.*.*..*...##....*.*#.......A#*...**.*........*.#.....***......##.....*.........*..##**..**......
...............*.....*..........**.**...#..A.#.##....*#..#..*....**...*.....#...*..#.#.*.*...#......
...#*.#*.......*.**#....#.*##.*...*.......*..#*..*......*.*.#*.*#...#.#*....*....#...###.*.....***..
......*........#*.......**.*...........*..........#*#.##...**.......*..#.......*..*.....#...........
......#..*...#*.#.*....*#.#**..#.......*...#..**....*..*......**#........*..*.*................*.*..
#.#.........#..#..**.............*..*.........#...*.#.*......#.*.##**.#.*..*..#.*.*.*..***.*.#...#*.
.*#.#...#..*.#.*..*........#..#..##*..*.......*#..*.*...#.*..#......*.....#*...****.*.......#.****..
.*...**.......#..*...........*.............#.*...............#.....#*...#...*..*....**....*...*.*.**
*.*.....*.#*....#....***.#.*#.*....*.##....*..*.#*..........#.*..**...#*#..*.....*......#*.*...#....
...#......*#.*...#...*......*.**..*..*.#..*.....**...#..*..#*.....*......**#...*.#.***#***.....#..##
*.*.......**..*#*...*#*.#..***..*.....*.*..*...*.##...##......#....#**.*...*.*.....##.....*....A...*
*.*.........*.....#.*...*.#.*...*...#..*..*.*...#.*...*...#..#......*..*.*...*.........*#...#...**..
...*...*.#.**...*.*.....*.*.*..*.#.....**.*#...#........*..*#.#..*...*#..*#.#..#.......*.#......*...
.....*#......*...*..*......*.#.*..*#..........#..#....*.#*........**.#*....*..#*.#....**..#......**.
..*.......#**.............*...*............*..........*.#..#.*.*.*.*.*...*.##......*...*..*...*.**#.
...**#...*...*..*...*..*...*...#.*.*..*.*..#..#........*.......***.....*...**.#............#..*.....
..#..*.*.*.***....##.**.#............**.#.........#..###..*.**..#*...#*..*..#*..*..***........#**.*.
.*.....**.**.*........#*#...*....*.**.#.*.........*......#.*.#..*##...**.#........*.*.........*.....
***#*....*.*...*#.*#...*.......*#*.....**....#.**.*..#................*....***.*..#.##.....**..*....
#*...*.**...#.......*.*.......*....**..*.#......#....*.#**.*..**.*...**......#.....*.*..............
.#.#*...#..#*.#.**##..*.....*.#*.#*.*...**....*....*......#......**..*.*..*...******.*...*......*...
.*.#.*..*....#.*..*...*A*..#...*...##..#*..#..*....*.*..*.#*..#....*..#.*.....*..#..###........*.**.
.......*...........*.......*.*.*..*....**.*..*..#...........*....#.*..........*.#*......#..**...*.#*
....*.*..*#.*....*B*.#..*..#..##.#..*.........#.......*......*#.#..*..*.........**....A.....*....**.
*##*.#...*....*#.....*..*.**.**...*.....*.#..*.*.*....#*........*.....#...*....***..*.#.........**#.
....*#*.*...****....*...#....*.....*.#......*.#.*#....#*...#*.....*..#....*.*...*..*..*.............
..**#*.***.#.*.*#..*.....#**#..*.*........*#.#...*......#**...#.....#.....#.**...*...*##.......*.#*.
*..#.**.#.#..*.###...*....*.*..#.....*.#***..#...*#..##...**#*.*........*........#...#..........*.*.
..*.*.#.#...*...*.**.#**..#...***.**....**#*#..#.*.*.*..*#.*.*.....**.#...#..*#**.....##.......*.###
.**...#*.*.*....*..**#..*.........*.....#..##......*....*#*.*.*..#....*.......#...*.#.***#*.......*.
..***..*...*#*#...#.**....**......*##..#.....*..............##.*.*.....**#......*.#.....#...#*.....#
....**.#....#..**..*........#..*....*...**..**.*#.#.......**.#*..#...*.*..#.*..*..*#..*....*#.......
*......**.*..*#..**...*.**...*...**###........*.*#....*..A.*.**.*...*...#...........#.**#..*..*....#
......**.#*....##.........#.***#......*##.**.....*#.......#..........***....#.*..**...**.**..#**.*#*
.*.....*..****.....*.........#.***.........**..*...*.*...*..*.*...*#....*#.*....*...*...*.....*.....
*...#.**.#........*....*..**...#....*#.##....#......#....#..#.#.......*....*.*.*..#.....*.#....*..*#
.#**##.**.*..........*.#.*.*.#.*#**...........#..*....***#...#........#.....*#.....*.#..*....##.*..*
*.#..#.....#...#...*.#...........*.*...*.*.#*#...**...*........*.....#.......*...*....*..*..*......*
....*..*..#.*#...#.#*......*.*.*.............*.*##.....*........#.**........*..#..#**#...*....*.*...
...*.*#...........#*#*...**#....*....*....*.*....*....*.*...****.#.....#.#.........*.....#...****.*#
*..**..*...*.*..........*....#..#...*.*.....#..#...*#....**...*.**...**....*.........*....##...#.*#*
***..*.....*...**..**.*...........*..*....*##...*..#*.*.........................#.*.#***..**..*...*.
....*.***....*#.##....*.*...#.....*......**..*........*.*#*.*.....*.....#.#****..#..*.*..*.*.....#*.
#.*..*.*....#*##***.......*...*..*....*........*..*#*.#.##*..**..#.*.....#..*.....*.............*...
#............#...*.*..*.*.......*..........#...*........#*.*.#..#...**#....*...#.*.#*..*.*#*...*..#.
...*..*...#....****......#.**...*.***..*..*.....*...#....#*........*.......*.**..*##..*#.**..*...#..
#.....*.......#..***..*..#......#.#.#...*.....#..*###..*...*.......#..*.*.***....#...*#..*.......#*.
.*....#.#...........**...*....*...*...*#......*.#.*.*...#..*....*......*......#.#.......*......*#***
*.....*.*....#....*#....*......#.*.#.#..*.....#.*..*...*#...*....*......*........*....#........#.*..
*..*#.*.#.......#.*.#..#..##*#....*..#.A*#*.......#....*...***............#..*.*..*..*...**.#..#...#
..##..*........*...*....*......*.......#.....*#....**#*.#....#....#*##..*.**.*..*..**.*...#.*..#....
*.#...#**......*..#*.*#*.***.**.#.#.#.*...*....*.#.*....*.......#..*.**..#........*#....#.....#.....
**.*#.*.##.#.*..*..*...........*...#....#...*.#..*.........***.........*..#.***.*.*.......#......#**
#......*...*...#.*..............*#.**...*...............*....*.*.#...*....#.....*.#.#.#**.........##
#..*#.##..#.**#.......*#.....#**.#........*...#.#......#*#.*#...*.##.....*...**.#.....#.*..*...*.**#
*..*...........*....*##**.###*....**...*#......*...#.*......*..**.....*....#..*..#..***..*.**.......
*.**..#.....#*.....*#.*..#*#..*..**#.*..*...*.*...**.*.#.....**.*....*..**.*#...##**#*##........*..*
*....#....*...#.#...*.....*...#.##....#.................#.*..........*......*..........#*.....*..*..
.#.*...........#.....#*.#........*.*.*.....*....#........*.*..*...........*.#*...........#.**...##..
.....#...#...#.#...#A.*..#...*....*..........***....**.*......*..*.*#*.#......#...*..#.#..#.*....*..
#.**.*..*..***.....*.#..*#....#..**....*...*....#.*.#..*..*.**.#..*.....#...#....#..*.#*....*...**..
..*..*...#..#.*.....*.*......**....*......*...............*....#.......*..*.*....*..#.*..*.#......#.
...*.....*#.......*#....*....*..#*#.**.........#..*....*......*.*..*.#.........*...*.#.#......#.##**
...*#....*......B.*.*......#...A...##.*.....*#.*..#*.*.*..*.*.#***....*.#....#..**.#..*.#*....*.#...
**........*.#..##*........#......*#...*...**..#*...........#..*#.#...........**.*...#....*#.B.....#*
